You wake up to the sound of your alarm clock. When packing your stuff to go to school, you realize your math homework is missing. You can't go to school without that math homework!

Lost Homework
An Interactive Fiction by tendo19
Release 1 / Serial number 190215 / Inform 7 build 6M62 (I6/v6.33 lib 6/12N) SD

Your Bedroom
Your bedroom is messy. There are clothes scattered around the floor. A small wooden desk sits in the corner of the room. There is a window next to the desk. There is a door on the east side of the room that leads to the backyard.

You can see a bedroom door here.

>e
(first opening the bedroom door)
It seems to be locked.

>take desk
That's hardly portable.

>take key
Taken.

* * *

>e
(first opening the bedroom door)
It seems to be locked.

>take key
Taken.

>e
(first opening the bedroom door)
It seems to be locked.

>use key
That's not a verb I recognise.

>unlock door
(with the key)
You unlock the bedroom door.

>e
(first opening the bedroom door)

Backyard
You see a doghouse, a small apple tree, and some freshly cut lawn. Your bedroom is to the west.

You can see a bedroom door and a homework here.

* * *

You wake up to the sound of your alarm clock. When packing your stuff to go to school, you realize your math homework is missing. You can't go to school without that math homework!

Lost Homework
An Interactive Fiction by tendo19
Release 1 / Serial number 190215 / Inform 7 build 6M62 (I6/v6.33 lib 6/12N) SD

Your Bedroom
Your bedroom is messy. There are clothes scattered around the floor. A small wooden desk sits in the corner of the room. There is a window next to the desk. There is a door on the east side of the room that leads to the backyard.

You can see a bedroom door here.

>examine desk
It's a small wooden desk. On top of it is a key and your school binder. There is no homework in sight. Your backpack is laying besides it.

In the desk are a key and a binder.

>get key
Taken.

>get binder
Taken.

>leave
But you aren't in anything at the moment.

>go to backyard
You can't see any such thing.

>go east
(first opening the bedroom door)
It seems to be locked.

>use key
That's not a verb I recognise.

>unlock door
What do you want to unlock the bedroom door with?

>key
You unlock the bedroom door.

>open door
You open the bedroom door.

>go west
You can't go that way.

>go east
Backyard
You see a doghouse, an apple tree, and a storage container. Your bedroom is to the west.

You can see a bedroom door here.

>open door
That's already open.

>go in
You can't go that way.

>go east
You can't go that way.

>go west
Your Bedroom
Your bedroom is messy. There are clothes scattered around the floor. A small wooden desk sits in the corner of the room. There is a window next to the desk. There is a door on the east side of the room that leads to the backyard.

You can see a bedroom door here.

>go west
You can't go that way.

* * *

You wake up to the sound of your alarm clock. When packing your stuff to go to school, you realize your math homework is missing. You can't go to school without that math homework!

Lost Homework
An Interactive Fiction by tendo19
Release 1 / Serial number 190215 / Inform 7 build 6M62 (I6/v6.33 lib 6/12N) SD

Your Bedroom
Your bedroom is messy. There are clothes scattered around the floor. A small wooden desk sits in the corner of the room. There is a window next to the desk. There is a door on the east side of the room that leads to the backyard.

You can see a bedroom door here.

>get key
Taken.

>unlock door
(with the key)
You unlock the bedroom door.

>open door
You open the bedroom door.

>e
You can't go that way.

* * *

You wake up to the sound of your alarm clock. When packing your stuff to go to school, you realize your math homework is missing. You can't go to school without that math homework!

Lost Homework
An Interactive Fiction by tendo19
Release 1 / Serial number 190215 / Inform 7 build 6M62 (I6/v6.33 lib 6/12N) SD

Your Bedroom
Your bedroom is messy. There are clothes scattered around the floor. A small wooden desk sits in the corner of the room. There is a window next to the desk. There is a door on the east side of the room that leads to the backyard.

You can see a bedroom door here.

>go to desk
You can't see any such thing.

>desk
That's not a verb I recognise.

>take key
Taken.

>go to door
You can't see any such thing.

>go to bedroom door
You can't see any such thing.

>e
(first opening the bedroom door)
It seems to be locked.

>x door
This door separates your room from the backyard.

>use key
That's not a verb I recognise.

>i
You are carrying:
  a key

>unlock door
(with the key)
You unlock the bedroom door.

* * *

>e
(first opening the bedroom door)

Backyard
You see a doghouse, a small apple tree, and some freshly cut lawn. Your bedroom is to the west.

You can see a bedroom door and a homework here.

>x doghouse
You see Molly, still sleeping. Under her, you see a piece of paper which you're certain is your math homework.

>x small apple tree
You can't see any such thing.

>x apple tree
It is slightly taller than you. The apples aren't ready to harvest.

* * *

You wake up to the sound of your alarm clock. When packing your stuff to go to school, you realize your math homework is missing. You can't go to school without that math homework!

Lost Homework
An Interactive Fiction by tendo19
Release 1 / Serial number 190215 / Inform 7 build 6M62 (I6/v6.33 lib 6/12N) SD

Your Bedroom
Your bedroom is messy. There are clothes scattered around the floor. A small wooden desk sits in the corner of the room. There is a window next to the desk. There is a door on the east side of the room that leads to the backyard.

You can see a bedroom door here.

>go to door
You can't see any such thing.

* * *

>go to bedroom door
You can't see any such thing.

>x door
This door separates your room from the backyard.

>open door
It seems to be locked.

>use key
That's not a verb I recognise.

>x desk
It's a small wooden desk. On top of it is a key and your school binder. There is no homework in sight. Your backpack is laying besides it.

>take key
You can't see any such thing.

>take biner
You can't see any such thing.

>take binder
That's hardly portable.

* * *

You wake up to the sound of your alarm clock. When packing your stuff to go to school, you realize your math homework is missing. You can't go to school without that math homework!

Lost Homework
An Interactive Fiction by tendo19
Release 1 / Serial number 190215 / Inform 7 build 6M62 (I6/v6.33 lib 6/12N) SD

Your Bedroom
Your bedroom is messy. There are clothes scattered around the floor. A small wooden desk sits in the corner of the room. There is a window next to the desk. There is a door on the east side of the room that leads to the backyard.

You can see a bedroom door here.

>take ke
You can't see any such thing.

>take key
Taken.

* * *

>e
(first opening the bedroom door)
It seems to be locked.

>unlock door
(with the key)
You unlock the bedroom door.

>e
(first opening the bedroom door)

Backyard
You see a doghouse, an apple tree, and a storage container. Your bedroom is to the west.

You can see a bedroom door here.

>x doghouse
You see Molly, still sleeping. You notice something under her.

In the doghouse is a rusted key.

>take rusted key
Taken.

>x storage container
There is a lock on it. There must be a key that can unlock it.

>unlock storage container
What do you want to unlock the storage container with?

>rusted key
You unlock the storage container.

>x storage container
There is a lock on it. There must be a key that can unlock it.

* * *

>unlock storage container
What do you want to unlock the storage container with?

>rusted key
That's unlocked at the moment.

>open containr
You can't see any such thing.

>open container
Which do you mean, the doghouse or the storage container?

>storage container
You open the storage container, revealing a homework.

>take homework
Taken.

>w
Your Bedroom
Your bedroom is messy. There are clothes scattered around the floor. A small wooden desk sits in the corner of the room. There is a window next to the desk. There is a door on the east side of the room that leads to the backyard.

You can see a bedroom door and a backpack (closed) here.

>x desk
It's a small wooden desk. On top of it is a key and your school binder. There is no homework in sight. Your backpack is laying besides it.

In the desk is a binder.

>take binder
Taken.

>put homework in the binder
The binder is closed.

>open binder
You open the binder.

>put homework in the binder
You put the homework into the binder.

>take backpack
Taken.

>open backpack
You open the backpack.

>put binder in the backpack
You put the binder into the backpack.

* * *

You wake up to the sound of your alarm clock. When packing your stuff to go to school, you realize your math homework is missing. You can't go to school without that math homework!

Lost Homework
An Interactive Fiction by tendo19
Release 1 / Serial number 190215 / Inform 7 build 6M62 (I6/v6.33 lib 6/12N) SD

Your Bedroom
Your bedroom is messy. There are clothes scattered around the floor. A small wooden desk sits in the corner of the room. There is a window next to the desk. There is a door on the east side of the room that leads to the backyard.

You can see a bedroom door here.

>take key
Taken.

* * *

>e
(first opening the bedroom door)

Backyard
You see a doghouse, an apple tree, and a storage container. Your bedroom is to the west.

You can see a bedroom door here.

>x apple tree
It is slightly taller than you. The apples aren't ready to harvest.

* * *

>e
(first opening the bedroom door)

Backyard
You see a doghouse, an apple tree, and a storage container. Your bedroom is to the west.

You can see a bedroom door here.

>x doghouse
You see Molly, still sleeping. Under her, you see a piece of paper which you're certain is your math homework.

In the doghouse is a rusted key.

* * *

>open door
You open the bedroom door.

>e
Backyard
You see a doghouse, an apple tree, and a storage container. Your bedroom is to the west.

You can see a bedroom door here.

>x doghouse
You see Molly, still sleeping. You notice something under her.

In the doghouse is a rusted key.

* * *

>take rusted key
Taken.

>x storage
There is a lock on it. There must be a key that can unlock it.

>unlock storage
What do you want to unlock the storage container with?

>rusted key
You unlock the storage container.

>open container
Which do you mean, the doghouse or the storage container?

>open storage
You open the storage container, revealing a homework.

>take homework
Taken.

>e
You can't go that way.

>w
Your Bedroom
Your bedroom is messy. There are clothes scattered around the floor. A small wooden desk sits in the corner of the room. There is a window next to the desk. There is a door on the east side of the room that leads to the backyard.

You can see a bedroom door and a backpack (closed) here.

>take
What do you want to take?

>nothing
You can't see any such thing.

>x desk
It's a small wooden desk. On top of it is a key and your school binder. There is no homework in sight. Your backpack is laying besides it.

In the desk is a binder.

>put homework in binder
The binder is closed.

>open binder
You open the binder.

>put homework in binder
You put the homework into the binder.

>open backpack
You open the backpack.

>put binder in the backpack
(first taking the binder)
You put the binder into the backpack.

>take backpack
Taken.

>take homework
Taken.

    *** You've won! ***

Would you like to RESTART, RESTORE a saved game, QUIT or UNDO the last command?

* * *

>take key
Taken.

>unlock door
(with the key)
You unlock the bedroom door.

* * *

>e
Backyard
You see a doghouse, an apple tree, and a storage container. Your bedroom is to the west.

You can see a bedroom door here.

>x doghouse
You see Molly, still sleeping. You notice a rusted key under her.

In the doghouse is a rusted key.

>take rusted key
Taken.

>unlock storage with rusted key
You unlock the storage container.

>open storage
You open the storage container, revealing a homework.

* * *

>e
You can't go that way.

>open binder
You can't see any such thing.

>put homework in binder
You can't see any such thing.

>i
You are carrying:
  a homework
  a rusted key
  a key

>put homework in the binder
You can't see any such thing.

>put the homework in the binder
You can't see any such thing.

>take binder
You can't see any such thing.

>x desk
You can't see any such thing.

>e
You can't go that way.

>w
Your Bedroom
Your bedroom is messy. There are clothes scattered around the floor. A small wooden desk sits in the corner of the room. There is a window next to the desk. There is a door on the east side of the room that leads to the backyard.

You can see a bedroom door here.

>open binder
You open the binder.

* * *

>put homework in binder
You put the homework into the binder.

>close binder
You close the binder.

>open backpack
You open the backpack.

>put. binder in backpack
You can't see any such thing.

>put binder in backpac
You can't see any such thing.

>oops backpack
(first taking the binder)
You put the binder into the backpack.

>take backpack
Taken.

>close backpack
You close the backpack.

>i
You are carrying:
  a backpack (closed)
  a rusted key
  a key

* * *

>take key
Taken.

>unlock door with key
You unlock the bedroom door.

>open door
You open the bedroom door.

* * *

>w
Your Bedroom
Your bedroom is messy. There are clothes scattered around the floor. A small wooden desk sits in the corner of the room. There is a window next to the desk. There is a door on the east side of the room that leads to the backyard.

You can see a bedroom door here.

>put homework in binder
The binder is closed.

* * *

>put homework in binder
You put the homework into the binder.

>open back pack
You can't see any such thing.

>openbackpack
That's not a verb I recognise.

>open backpack
You open the backpack.

>put binder in backpack
(first taking the binder)
You put the binder into the backpack.

>take backpack
Taken.

>i
You are carrying:
  a backpack (open)
    a binder (open)
      a homework
  a rusted key
  a key

>close binder
You close the binder.

>close backpck
You can't see any such thing.

>close backpack
You close the backpack.

* * *

You wake up to the sound of your alarm clock. When packing your stuff to go to school, you realize your math homework is missing. You can't go to school without that math homework!

Lost Homework
An Interactive Fiction by tendo19
Release 1 / Serial number 190215 / Inform 7 build 6M62 (I6/v6.33 lib 6/12N) SD

Your Bedroom
Your bedroom is messy. There are clothes scattered around the floor. A small wooden desk sits in the corner of the room. There is a window next to the desk. There is a door on the east side of the room that leads to the backyard.

You can see a bedroom door here.

>x bed
It is very messy. You should make your bed immediately.

* * *

You wake up to the sound of your alarm clock. When packing your stuff to go to school, you realize your math homework is missing. You can't go to school without that math homework!

Lost Homework
An Interactive Fiction by tendo19
Release 1 / Serial number 190215 / Inform 7 build 6M62 (I6/v6.33 lib 6/12N) SD

Your Bedroom
Your bedroom is messy. There are clothes scattered around the floor. A small wooden desk sits in the corner of the room. There is a window next to the desk. There is a door on the east side of the room that leads to the backyard.

You can see a bedroom door here.

>x clothes
You can't see any such thing.

* * *

You wake up to the sound of your alarm clock. When packing your stuff to go to school, you realize your math homework is missing. You can't go to school without that math homework!

Lost Homework
An Interactive Fiction by tendo19
Release 1 / Serial number 190215 / Inform 7 build 6M62 (I6/v6.33 lib 6/12N) SD

Your Bedroom
Your bedroom is messy. There are clothes scattered around the floor. A small wooden desk sits in the corner of the room. There is a window next to the desk. There is a door on the east side of the room that leads to the backyard.

You can see a bedroom door here.

>x desk
It's a small wooden desk. On top of it is a key and your school binder. There is no homework in sight. Your backpack is laying besides it.

In the desk are a key and a binder.

>get ke
You can't see any such thing.

>oops key
Taken.

>x key
It gives you access to your room.

>unlock door
(with the key)
You unlock the bedroom door.

* * *

>e
Backyard
You see a doghouse, an apple tree, and a storage container. Your bedroom is to the west.

You can see a bedroom door here.

>open container
Which do you mean, the doghouse or the storage container?

>doghouse
It isn't something you can open.

>storage container
That's not a verb I recognise.

>open storage container
It seems to be locked.

>unlock storage container
(with the key)
That doesn't seem to fit the lock.

>x tree
It towers over you, but the apples aren't ready to harvest yet. You see something hanging on the branches, but you aren't sure what it is.

>x thing
You can't see any such thing.

>x branches
You can't see any such thing.

>x doghouse
You see Molly, still sleeping. You notice a rusted key under her.

In the doghouse is a rusted key.

>get rusted key
Taken.

>unlock storage container
What do you want to unlock the storage container with?

* * *

>rusted key
You unlock the storage container.

>open storage container
You open the storage container, revealing a homework.

>get homework
Taken.

>w
Your Bedroom
Your bedroom is messy. There are clothes scattered around the floor. A small wooden desk sits in the corner of the room. There is a window next to the desk. There is a door on the east side of the room that leads to the backyard.

You can see a bedroom door here.

>x desk
It's a small wooden desk. On top of it is a key and your school binder. There is no homework in sight. Your backpack is laying besides it.

In the desk is a binder.

>put binder in backpack
(first taking the binder)
The backpack is closed.

>open backpack
You open the backpack.

>put binder in backpack
You put the binder into the backpack.

>take binder from backpack
Taken.

>put homework in binder
The binder is closed.

* * *

>close binder
You close the binder.

>put binder in backpack
You put the binder into the backpack.

>close backpack
You close the backpack.

>take backpack
Taken.

>i
You are carrying:
  a backpack (closed)
  a rusted key
  a key

>x backpack
It is your backpack that you bring to school everyday.

>drop backpack
Dropped.

>open backpack
You open the backpack, revealing a binder.

>take binder
Taken.

>close backpack
You close the backpack.

* * *

>take backpack
Taken.

>i
You are carrying:
  a backpack (closed)
  a binder (closed)
  a rusted key
  a key

>jump
You jump on the spot.

>eat backpack
That's plainly inedible.

>eat backpack
That's plainly inedible.

>take homework
You can't see any such thing.

>open binder
You open the binder, revealing a homework.

>take homework
Taken.

    *** You've won! ***

Would you like to RESTART, RESTORE a saved game, QUIT or UNDO the last command?

* * *

>x desk
It's a small wooden desk. On top of it is a key and your school binder. There is no homework in sight. Your backpack is laying besides it.

In the desk are a key and a binder.

>take key
Taken.

* * *

>go to door
You can't see any such thing.

>go to east side door
You can't see any such thing.

>east
(first opening the bedroom door)
It seems to be locked.

>use key
That's not a verb I recognise.

* * *

>unlock door
(with the key)
You unlock the bedroom door.

>go east
(first opening the bedroom door)

Backyard
You see a doghouse, an apple tree, and a storage container. Your bedroom is to the west.

You can see a bedroom door here.

>x apple tree
It towers over you, but the apples aren't ready to harvest yet. You see something hanging on the branches, but you aren't sure what it is.

>climb tree
Little is to be achieved by that.

>x storage container
There is a lock on it. There must be a key that can unlock it.

>unlock door
(with the key)
That's unlocked at the moment.

>unolck container
That's not a verb I recognise.

>unlock container
Which do you mean, the doghouse or the storage container?

>the dog house
You can't see any such thing.

>the doghouse
That's not a verb I recognise.

>unlock storage container
(with the key)
That doesn't seem to fit the lock.

>unlock dog house
You can't see any such thing.

>unlock doghouse
(with the key)
That doesn't seem to be something you can unlock.

>x doghouse
You see Molly, still sleeping. You notice something under her.

In the doghouse is a rusted key.

* * *

>take rusted key
Taken.

>unlock storage container
What do you want to unlock the storage container with?

>rusty key
You can't see any such thing.

>unlock doghouse
What do you want to unlock the doghouse with?

>unlock storage container
What do you want to unlock the storage container with?

* * *

>x storage container
There is a lock on it. There must be a key that can unlock it.

>unlock it
What do you want to unlock the storage container with?

>rusted key
That's unlocked at the moment.

>open
What do you want to open?

>storage container
You open the storage container, revealing a homework.

* * *

>take homework
Taken.

>go back west
You can't see any such thing.

>go back east
You can't see any such thing.

>go west
Your Bedroom
Your bedroom is messy. There are clothes scattered around the floor. A small wooden desk sits in the corner of the room. There is a window next to the desk. There is a door on the east side of the room that leads to the backyard.

You can see a bedroom door and a backpack (closed) here.

>x desk
It's a small wooden desk. On top of it is a key and your school binder. There is no homework in sight. Your backpack is laying besides it.

In the desk is a binder.

>take the binder
Taken.

>put homework in binder
The binder is closed.

* * *

>open binder
You open the binder.

>place homework in the binder
That's not a verb I recognise.

>put homework in binder
You put the homework into the binder.

* * *

>close binder
You close the binder.

>put binder in bag
You can't see any such thing.

>put binder in backpack
The backpack is closed.

>open backpack
You open the backpack.

>put binder in
What do you want to put the binder in?

>backpack
You put the binder into the backpack.

>close backpack
You close the backpack.

* * *

>x desk
It's a small wooden desk. On top of it is a key and your school binder. There is no homework in sight. Your backpack is laying besides it.

In the desk are a key and a binder.

>x binder
It's full of past schoolwork, but you don't see your math homework.

>take binder
Taken.

>take key
Taken.

>i
You are carrying:
  a key
  a binder

* * *

>x desk
It's a small wooden desk. On top of it is a key and your school binder. There is no homework in sight. Your backpack is laying besides it.

In the desk are a key and a binder.

>x the desk
You can't see any such thing.

>x The desk
You can't see any such thing.

* * *

>x desk
It's a small wooden desk. On top of it is a key and your school binder. There is no homework in sight. Your backpack is laying besides it.

In the desk are a key and a binder.

>x window
It is slightly open. No wonder why it was cold last night.

>x key
It gives you access to your room.

>x binder
It's filled with past schoolwork, but you don't see your math homework.

>e
You can't go that way.

>unlock door
What do you want to unlock the bedroom door with?

>key
(first taking the key)
You unlock the bedroom door.

>e
You can't go that way.

>open door
You open the bedroom door.

* * *

>e
You can't go that way.

>w
You can't go that way.

>n
You can't go that way.

>s
You can't go that way.

>se
You can't go that way.

>sw
You can't go that way.

>open winow
You can't see any such thing.

>oops window
It isn't something you can open.

>x clothes
What a mess. You should put your clothes in the laundry basket after school.

>open door
That's already open.

>go through door
You can't go that way.

>e
You can't go that way.

>restart
Are you sure you want to restart?

>yes
You wake up to the sound of your alarm clock. When packing your stuff to go to school, you realize your math homework is missing. You can't go to school without that math homework!

Lost Homework
An Interactive Fiction by tendo19
Release 1 / Serial number 190213 / Inform 7 build 6M62 (I6/v6.33 lib 6/12N) SD

Your Bedroom
Your bedroom is messy. There are clothes scattered around the floor. A small wooden desk sits in the corner of the room. There is a window next to the desk. There is a door on the east side of the room that leads to the backyard.

>open door
It seems to be locked.

>get key
Taken.

* * *

You wake up to the sound of your alarm clock. When packing your stuff to go to school, you realize your math homework is missing. You can't go to school without that math homework!

Lost Homework
An Interactive Fiction by tendo19
Release 1 / Serial number 190215 / Inform 7 build 6M62 (I6/v6.33 lib 6/12N) SD

Your Bedroom
Your bedroom is messy. There are clothes scattered around the floor. A small wooden desk sits in the corner of the room. There is a window next to the desk. There is a door on the east side of the room that leads to the backyard.

You can see a bedroom door here.

>x the bed
You can't see any such thing.

>x bed
You can't see any such thing.

* * *

You wake up to the sound of your alarm clock. When packing your stuff to go to school, you realize your math homework is missing. You can't go to school without that math homework!

Lost Homework
An Interactive Fiction by tendo19
Release 1 / Serial number 190215 / Inform 7 build 6M62 (I6/v6.33 lib 6/12N) SD

Your Bedroom
Your bedroom is messy. There are clothes scattered around the floor. A small wooden desk sits in the corner of the room. There is a window next to the desk. There is a door on the east side of the room that leads to the backyard.

You can see a bedroom door here.

>x the desk
A small wooden desk. On top of it is a key and your school binder. There is no homework in sight. Your backpack is laying besides it.

>x desk
You can't see any such thing.

>e
Backyard
You see a doghouse, a small apple tree, and some freshly cut lawn. Your bedroom is to the west.

>w
Your Bedroom
Your bedroom is messy. There are clothes scattered around the floor. A small wooden desk sits in the corner of the room. There window next to your desk. There is a door on the east side of the room that leads to the backyard.